p

 A#A :: A#B
 ::::::::::::::::::::::::::::
 B#A :: B#B
 C#A :: C#B
 D#A :: D#B


 A#A .................... A#B
 ::::::::::::::::::::::::::::
 B#A .................... B#B
 C#A .................... C#B
 D#A .................... D#B
p
p
